111111111
100000001
101101101
101111101
100010001
100010001
100010001
1P00C0001
1000C0G01
1000C0001
1011E1101
101111101
111111111